111111111111111
1P00CCC0CCC00E1
1P0000C0C0C00E1
1P00CCC0CCC00E1
1P0000C000C00E1
1P00CCC0CCC00E1
111111111111111