11111111111111111
1P00CCC0CCC0C00E1
1P00C0C000C0C00E1
1P00CCC0CCC0C00E1
1P00C0C000C0C00E1
1P00CCC0CCC0C00E1
11111111111111111