111111111111111
1ZZZZZZZZZZZZZ1
1ZZZZZZZZZZZZZ1
1ZZZZZZZZZZZZZ1
1ZZZ00110000001
1ZZZ001CCCC00P1
1ZZZ0Z00CCC0001
1ZZZ010CZ0C0001
100001ECCC000Z1
111111111111111