111111111
1CC000CC1
1C11P11C1
101000101
1000E0001
101000101
1C11011C1
1CC000CC1
111111111