111111111111111111
1P00000CCC000000E1
111111111111111111