111111111
1P00C00E1
111111111
1PC000C01
111111111