1111111111111111
1111111111111001
1111111111000ZZ1
1111111110000001
1111111000000001
1111000000000001
1111000000000ZZ1
1110000000000001
1110000000000001
1111100000000ZZ1
1111100000000001
1111100000000001
1111110000000001
1E000000000C00P1
1111111111111111