111111111111111
1P0000011111111
10C000001111111
100C00000111111
1000C0000011111
10000C000001111
100000C00000111
1100000C0000011
11100000C000001
111100000C00001
1111100000C0001
11111100000C001
111111100000C01
1111111100000E1
111111111111111