111111111111111
1000000E0000001
100000CCC000001
100001111100001
100010000010001
100100111001001
10C101000101C01
10C101000101C01
10C101000101C01
100100111001001
100010000010001
100001111100001
100000CCC000001
1000000P0000001
111111111111111