11111111111111111111
10000111111111111111
100001ZZZZZZZZZZZZ11
1P0000CCCCCCCCCCCCE1
100001ZZZZZZZZZZZZ11
10000111111111111111
11111111111111111111