11111111111
1CC00C00CC1
1C111P111C1
101Z000Z101
10100000101
1C1Z0E0Z1C1
10100000101
10100Z00101
1C1111111C1
1CC00C00CC1
11111111111