1111111111
1000000001
10PCCC0001
100000C001
1000110001
1000110001
10Z011CE01
1111111111