111111111111111
1EC000000000001
1C0ZZZZZZZZZ001
10Z000000000Z01
10Z000000000Z01
10Z000000000Z01
10Z000000000Z01
10Z0000P0000Z01
10Z000000000Z01
10Z000000000Z01
10Z000000000Z01
10Z000000000Z01
100ZZZZZZZZZ001
100000000000001
111111111111111