111111111111111111111111111
1CCC0CC1CCC00CC1C0000001111
1CCC0CC1CCC00CC1C0CCCC01111
1000000100000001C0CCCC01111
1C00000000000001000P0001111
1C0CC00100CC00C1C0000000011
1C0CC01110CC00C1C00001000C1
100CC01110CC00C1C0001100C11
100000010000000100001110111
100110111011000000001111111
100100111001000100001111111
110100111001111111E11111111
100100010001000000001100001
100100010001000000000000001
111111111111111111111111111