1111111111111111111111111111111
1P000CC0CC00CCC0C00C0C0000C00E1
1P00C0CCC0C00C00C0C00C0000C00E1
1P00C00C00C00C00CC000C0000C00E1
1P00C00C00C00C00CC000C0000C00E1
1P00C00C00C00C00C0C00CC00CC00E1
1P00C00C00C0CCC0C00C00CCCC000E1
1111111111111111111111111111111