111111111111111111111111111111111111111111
1000000000000000000000000000000000000000E1
10C000000000000000000000000000000000000C01
100000000000000000000000000000000000000001
100000000000000000000000000000000000000001
100000000000000000000000000000000000000001
100000000000000000000000000000000000000001
100000000000000000000000000000000000000001
100000000000000000000000000000000000000001
100000000000000000000000000000000000000001
100000000000000000000000000000000000000001
100000000000000000000000000000000000000001
100000000000000000000000000000000000000001
100000000000000000000000000000000000000001
100000000000000000000000000000000000000001
100000000000000000000000000000000000000001
100000000000000000000000000000000000000001
10000000000000000000000000000000000000C001
1P0000000000000000000000000000000000000001
111111111111111111111111111111111111111111