111111111
1CCZ00001
1CC100001
111100001
100000001
100001111
1000010Z1
1P00000E1
111111111