11111111
10000001
100CC001
10CZZC01
10CZZC01
100CC001
1P0000E1
11111111