111111111111111
11Z1Z1Z1Z1Z1Z11
1ZPC0C0C0C0C0E1
11Z1Z1Z1Z1Z1Z11
111111111111111