11111111111
1P100C00001
10101111101
10101C00101
10101010101
1C1C1E1C1C1
10101110101
10100C00101
10111111101
10000C00001
11111111111