111111
100001
111111

111111
1PC0E1
111111