111111111
1C00000C1
1C00000E1
111000111
111C00111
111000111
111000111
111C00111
1110P0111
111111111