111111111111111111111111111
100000000000000000101000001
1000CCC00000000000101000001
100CCC000000000000000000001
10CCCCCEC100000000000Z0E001
11111111110001100000ZZ00001
10000000PPP00010000000Z0001
1Z000000PPP0001000000000001
10000000PPP0001111111111111
111111111111011000000000001
100000000000000000000000001
100000000000000000000000001
1000000E000000000000000E001
111111111111111111111111111