111111111111
1000000000P1
100CCCCCC001
100111111001
1E1Z0Z0Z0101
111111111111