11111111
100000E1
10000001
11111111
1CCC0001
1P000001
11111111