11111111
1CC00001
1CC00001
11111111
1CCC00E1
1P000001
11111111